111111111111111111111111111111
100000000000000000000000000001
100000000010000000100000000001
100000111000000000001000000011
100000000000000000000000000001
101000000000010000000000010001
10000000000000000000E000000001
100000C00000000000001000000001
100000111000000000000000000001
10000000000001110000000000C001
100000000000000000000000000001
1000000000P000C000001111000001
100011100000000000100000000001
100000000000000000000000000001
111111111111111111111111111111